{
  "level1": {
    "background": [
      ["w","w","w","w","w","w","w","w","w","w","w","w","w","w","w"],
      ["w","f","f","f","f","f","f","f","f","f","w","f","f","f","w"],
      ["w","w","w","w","w","f","w","f","w","w","w","f","w","f","w"],
      ["w","f","f","f","f","f","f","w","f","f","f","f","w","f","w"],
      ["w","f","w","f","f","w","w","w","w","w","w","f","w","f","w"],
      ["w","f","w","f","f","f","f","f","f","f","w","f","w","f","f"],
      ["w","w","w","w","w","w","w","f","w","f","w","f","f","f","w"],
      ["w","f","f","f","f","f","f","f","w","f","w","f","w","f","w"],
      ["w","f","w","f","w","w","w","f","w","f","w","f","f","f","w"],
      ["w","f","w","f","f","f","w","f","w","f","w","w","f","w","w"],
      ["w","f","w","f","w","f","f","f","w","f","w","f","f","f","w"],
      ["w","f","w","w","w","w","w","w","w","f","w","f","w","f","w"],
      ["f","f","w","f","f","f","w","f","f","f","w","f","w","f","w"],
      ["w","f","f","f","w","f","f","f","w","f","f","f","w","f","w"],
      ["w","w","w","w","w","w","w","w","w","w","w","w","w","w","w"]
    ],
    "humans": [
      [12, 0],
      [5, 13]
    ],
    "exit": [
      [5, 14]
    ]
   },
  "level2": ["hello hello"]
}

